=========  =========
=..................=
==========.........=
....................
=....===============
=..................=
=========..======..=
=======....======..=
=..G...............=
=..=======.........=
...g................
=.........==========
=..................=
=========..=======.=
====...........===.=
=... ========......=
=..................=
===========...======
=..................=
=========  =========